....#.....
.........#
..........
..#.......
.......#..
..........
.#.O^.....
......OO#.
#O.O......
......#...